ubnd	ủy ban nhân dân
tand	tòa án nhân dân
ca	công an
ntd	nhà thi đấu
vđv	vận động viên
cđv	cổ động viên
svđ	sân vận động
thpt	trung học phổ thông
thcs	trung học cơ sở
gd&đt	giáo dục và đào tạo
gdđt	giáo dục đào tạo
gd-đt	giáo dục đào tạo
pgs	phó giáo sư
hcm	hồ chí minh
tdtt	thể dục thể thao
clb	câu lạc bộ
csgt	cảnh sát giao thông
cscđ	cảnh sát cơ động
nhnn	ngân hàng nhà nước
tphcm	thành phố hồ chí minh
vpcp	văn phòng chính phủ
vpqh	văn phòng quốc hội
bca	bộ công an
sn	sinh năm
vhtt	văn hóa thể thao
vhttdl	văn hóa thể thao du lịch
vhtt-dl	văn hóa thể thao du lịch
vh-tt-dl	văn hóa thể thao du lịch
hlv	huấn luyện viên
hcv	huy chương vàng
hcb	huy chương bạc
hcđ	huy chương đồng
lđ-tb&xh	lao động thương binh và xã hội
cntt	công nghệ thông tin
bhyt	bảo hiểm y tế
bhxh	bảo hiểm xã hội
dn	doanh nghiệp
nlđ	người lao động
bhtn	bảo hiểm thất nghiệp
lđtbxh	lao động thương binh xã hội
lđlđ	liên đoàn lao động
vn	việt nam
hn	hà nội
btc	ban tổ chức
xklđ	xuất khẩu lao động
hđqt	hội đồng quản trị
tand	tòa án nhân dân
ndt	nhân dân tệ
lđbđ	liên đoàn bóng đá
nn&ptnt	nông nghiệp và phát triển nông thôn
nn-ptnt	nông nghiệp phát triển nông thôn
hagl	hoàng anh gia lai
đhbk	đại học bách khoa
đhbkhn	đại học bách khoa hà nội
đh	đại học
khcn	khoa học công nghệ
mxh	mạng xã hội
tnmt	tài nguyên môi trường
tn&mt	tài nguyên và môi trường
tn-mt	tài nguyên môi trường
fb	facebook
vck	vòng chung kết
gtvt	giao thông vận tải
tt&tt	thông tin và truyền thông
tttt	thông tin truyền thông
tt-tt	thông tin truyền thông
qlnn	quản lý nhà nước
kh&đt	kế hoạch và đầu tư
khđt	kế hoạch đầu tư
kh-đt	kế hoạch đầu tư
ubdt	ủy ban dân tộc
ttcp	thanh tra chính phủ
cty	công ty
kcnc	khu công nghệ cao
tnhh	trách nhiệm hữu hạn
lmht	liên minh huyền thoại
tmdv	thương mại dịch vụ
hđqt	hội đồng quản trị
sx-kd	sản xuất kinh doanh
sxkd	sản xuất kinh doanh
tgdđ	thế giới di động
đhxd	đại học xây dựng
ktqd	kinh tế quốc dân
gdcd	giáo dục công dân
lhq	liên hợp quốc
anmt	an ninh môi trường
anqg	an ninh quốc gia
anptt	an ninh phi truyền thông
annd	an ninh nhân dân
cand	công an nhân dân
anm	an ninh mạng
xhcn	xã hội chủ nghĩa
chxhcn	cộng hòa xã hội chủ nghĩa
bđkh	biến đổi khí hậu
ônmt	ô nhiễm môi trường
đbscl	đồng bằng sông cửu long
ttxvn	thông tấn xã việt nam
gtgt	gía trị gia tăng
pct	phó chủ tịch
đsq	đại sứ quán
tq	trung quốc
bđbp	bộ đội biên phòng
pkkq	phòng không không quân
pk-kq	phòng không không quân
ktqs	kỹ thuật quân sự
hvktqs	học viện kỹ thuật quân sự
khqs	khoa học quân sự
cskh	chăm sóc khách hàng
ctkm	chương trình khuyến mại
tvts	tư vấn tuyển sinh
httt	hệ thống thông tin
khmt	khoa học máy tính
vna	vietnam airlines
đbqh	đại biểu quốc hội
btv	biên tập viên
ptv	phát thanh viên
blv	bình luận viên
kts	kiến trúc sư
ktv	kỹ thuật viên
qtv	quản trị viên
ttcn	thị trường chuyển nhượng
blđ	ban lãnh đạo
cmcn	cách mạng công nghiệp
khtn	khoa học tự nhiên
kdcn	kinh doanh công nghệ
bcvt	bưu chính viễn thông
ttvh	thể thao văn hóa
hkqt	hàng không quốc tế
lđbđ	liên đoàn bóng đá
đtqg	đội tuyển quốc gia
đkvđ	đương kim vô địch
ưcv	ứng cử viên
vck	vòng chung kết
hdsd	hướng dẫn sử dụng
ptnk	phổ thông năng khiếu
đbs	đảng cộng sản
bđs	bất động sản
ntk	nhà thiết kế
csgt	cảnh sát giao thông
csđt	cảnh sát điều tra
anđt	an ninh điều tra
cscđ	cảnh sát cơ động
cmnd	chứng minh nhân dân
cmtnd	chứng minh thư nhân dân
tand	tòa án nhân dân
vks	viện kiểm sát
atlđ	an toàn lao động
nlđ	người lao động
antđ	an ninh thủ đô
bđbp	bộ đội biên phòng
htx	hợp tác xã
kcn	khu công nghiệp
nhm	người hâm mộ
đhtb	đội hình tiêu biểu
attt	an toàn thông tin
svattt	sinh viên an toàn thông tin
mtb máy	tính bảng
attp	an toàn thực phẩm
vsattp	vệ sinh an toàn thực phẩm
ctcp	công ty cổ phần
lntt	lợi nhuận trước thuế
lnst	lợi nhuận sau thuế
đna	đông nam á
ntđ	nhà thi đấu
atgt	an toàn giao thông
đhqg	đại học quốc gia
tbn	tây ban nha
bđn	bồ đào nha
thvl	truyền hình vĩnh long
nsnd	nghệ sĩ nhân dân
nsưt	nghệ sĩ ưu tú
hhhv	hoa hậu hoàn vũ
gđđh	giám đốc điều hành
bxh	bảng xếp hạng
bks	biển kiểm soát
tgđ	tổng giám đốc
pgsts	phó giáo sư tiến sĩ
pgs-ts	phó giáo sư tiến sĩ
gsts	giáo sư tiến sĩ
gs-ts	giáo sư tiến sĩ
ngnd	nhà giáo nhân dân
gplx	giấy phép lái xe
hđnd	hội đồng nhân dân
kt-xh	kinh tế xã hội
ktxh	kinh tế xã hội
bch	ban chấp hành
mttq	mặt trận tổ quốc
gtđt	giao tiếp điện tử
gpkd	giấy phép kinh doanh
gdck	giao dịch chứng khoán
tpcp	trái phiếu chính phủ
kbnn	kho bạc nhà nước
đkkd	đăng ký kinh doanh
pnvn	phụ nữ việt nam
đkkh	đăng ký kết hôn
plđs	pháp luật đời sống
đspl	đời sống pháp luật
ctv	cộng tác viên
ttgt	thanh tra giao thông
cbnv	cán bộ nhân viên
gpmb	giải phóng mặt bằng
tmcp	thương mại cổ phần
nhtm	ngân hàng thươn mại
bđvn	bóng đá việt nam
csnd	cảnh sát nhân dân
pccc	phòng cháy chữa cháy
vqg	vườn quốc gia
bql	ban quản lý
ptdtbt	phổ thông dân tộc bán trú
hdv	hướng dẫn viên
tsbs	tiến sĩ bác sĩ
ts-bs	tiến sĩ bác sĩ
pgsbs	phó giáo sư bác sĩ
pgs-bs	phó giáo sư bác sĩ
gsbs	giáo sư bác sĩ
gs-bs	giáo sư bác sĩ
nsx	nhà sản xuất
thptqg	trung học phổ thông quốc gia
stt	số thứ tự
cntt&tt	công nghệ thông tin và truyền thông
cntt-tt	công nghệ thông tin truyền thông
mssv	mã số sinh viên
nxb	nhà xuất bản
lđbđvn	liên đoàn bóng đá việt nam
tthlttgq	trung tâm huấn luyện thể thao quốc gia
ndt	nhân dân tệ
qhtd	quan hệ tình dục
blhs	bộ luật hình sự
hđxx	hội đồng xét xử
cqca	cơ quan công an
dbkttv	dự báo khí tượng thủy văn
ttdbkttv	trung tâm dự báo khí tượng thủy văn
ttdbkttvtw	trung tâm dự báo khí tượng thủy văn trung ương
ttdbkttvtư	trung tâm dự báo khí tượng thủy văn trung ương
tw	trung ương
tư	trung ương
kttv	khí tượng thủy văn
ncs	nghiên cứu sinh
đtvt	điện tử viễn thông
ubkt	ủy ban kiểm tra
cpdv	cổ phần dịch vụ
đhđ	đại hội đồng
bvđk	bệnh viện đa khoa
btm	bộ tham mưu
bccb	binh chủng công binh
qđnd	quân đội nhân dân
llvt	lực lượng vũ trang
chqs	chỉ huy quân sự
sscđ	sẵn sàng chiến đấu
tckt	tổng cục kỹ thuật
csb	cảnh sát biển
tchc	tổng cục hậu cần
xnk	xuất nhập khẩu
csvn	cảnh sát việt nam
đbs	đảng cộng sản
tbt	tổng bí thư
ctn	chủ tịch nước
ttbh	trung tâm bảo hành
qlnn	quản lý nhà nước
cntd	chuyển nhượng tự do
đhqghn	đại học quốc gia hà nội
đhqg-hcm	đại học quốc gia hồ chí minh
đhqg	đại học quốc gia
btl	bộ tư lệnh
ktnn	kiểm toán nhà nước
thvn	truyền hình việt nam
đthvn	đài truyền hình việt nam
đptthn	đài phát thanh truyền hình hà nội
ptth	phát thanh truyền hình
shk	sổ hộ khẩu
gplđ	giấy phép lao động
gpxd	giấy phép xây dựng
ubkttw	ủy ban kiểm tra trung ương
ubkttư	ủy ban kiểm tra trung ương
atnđ	áp thấp nhiệt đới
hđh	hệ điều hành
đtnvn	đài tiếng nói việt nam
tnvn	tiếng nói việt nam
qbv	quả bóng vàng
bvbm	bệnh viện bạch mai
qltt	quản lý thị trường
tmđt	thương mại điện tử
xsmb	xổ số miền bắc
kqxs	kết quả xổ số
kqxsmb	kết quả sổ số miền bắc
pttm	phẫu thuật thẩm mỹ
ksnd	kiểm sát nhân dân
vksnd	viện kiểm sát nhân dân
vksndtc	viện kiểm sát nhân dân tối cao
chdcnd	cộng hòa dân chủ nhân dân
chnd	cộng hòa nhân dân
tandtc	tòa án nhân dân tối cao
thtt	truyền hình trực tiếp
bst	bộ sưu tập
ntk	nhà thiết kế
skđa	sân khấu điện ảnh
cqđt	cơ quan điều tra
bcvt	bưu chính viễn thông
hvbctt	học viện báo chí tuyên truyền
gđkt	giám đốc kỹ thuật
gđtt	giám đốc thể thao
htxnn	hợp tác xã nông nghiệp
bvtv	bảo vệ thực vật
qlcl	quản lý chất lượng
gvcn	giáo viên chủ nhiệm
xskt	xổ số kiến thiết
nha	ngoại hạng anh
vđqg	vô địch quốc gia
ktx	ký túc xá
cchc	cải cách hành chính
ubdt	ủy ban dân tộc
đbkk	đặc biệt khó khăn
antq	an ninh tổ quốc
cshs	cảnh sát hình sư
tngt	tai nạn giao thông
thads	thi hành án dân sự
tha	thi hành án
tt&dl	thể thao và du lịch
ntbd	nghệ thuật biểu diễn
nvqs	nghĩa vụ quân sự
đhcđ	đại hội công đoàn
qtđt	quy tắc đô thị
khxh&nv	khoa học xã hội và nhân văn
khxh-nv	khoa học xã hội nhân văn
hssv	học sinh sinh viên
gdct&ct	giáo dục chính trị và công tác
gdct-ct	giáo dục chính trị công tác
gdct	giáo dục chính trị
hđxx	hội đồng xét xử
kđt	khu đô thị
kđtm	khu đô thị mới
bhl	ban huấn luyện
gstskh	giáo sư tiến sĩ khoa học
gs-tskh	giáo sư tiến sĩ khoa học
nsnn	ngân sách nhà nước
hđba	hội đồng bảo an
hđbalhq	hội đồng bảo an liên hợp quốc
cđm	cộng đồng mạng
ubqpan	ủy ban quốc phòng an ninh
bvmt	bảo vệ môi trường
catp	công an thành phố
ttck	thị trường chứng khoán
pctn	phòng chống tham nhũng
ubtv	ủy ban thường vụ
ubtvqh	ủy ban thường vụ quốc hội
hđtv	hội đồng thành viên
gdđh	giáo dục đại học
dnnn	doanh nghiệp nhà nước
tttm	trung tâm thương mại
chk	cảng hàng không
tccn	trung cấp chuyên nghiệp
sggp	sài gòn giải phóng
kcb	khám chữa bệnh
ttxvn	thông tấn xã việt nam
svđqg	sân vận động quốc gia
